11111111111111111111111111111111111111111111111111:
10000020000100000001000000000010000000100002000001:
10111111110101110101011111111010101110101111111101:
10010000000000000100010000001010100000000000001001:
11010101010101110101010111101010101110101010101011:
11010101010100200101010000001010100200101010101011:
11010101010111111101010111101010111111101010101011:
10000100000000000001000000000010000000000000100001:
10111111110111110111011111111011101111101111111101:
10000100000000010000010000001000001000000000100001:
10110101111111011101110111101110111011111110101101:
10112101000100000000000000000000000000100010121101:
10110101010101110111101111110111101110101010101101:
10000001010001000000101000010100000010001010000001:
11110111010111011110100011000101111011101011101111:
10000001010000001110110111101101110000001010000001:
10111101010110100200000011000000200101101010111101:
10111101010000111111011000011011111100001010111101:
10002100000110000001001011010010000001100000120001:
10110101111111111101100000000110111111111110101101:
10000000000001000001000111100010000010000000000001:
11111101111101011101010111101010111010111110111111:
10000000010000000100010000001000100000001000000001:
10111111010101010101110111101110101010101011111101:
10100000010101010100000000000000101010101000000101:
10121111010001000101110111101110100010001011112101:
10100000011101011100010000001000111010111000000101:
10111111010000000101011011011010100000001011111101:
10000000000111110101000000000010101111100000000001:
11111011110000000101011111111010100000001111011111:
10000000011111110001010000001010001111111000000001:
10101101000200010101010111101010101000200010110101:
10101101011111010101010111101010101011111010110101:
10000000000000000100000000000000000000000000000001:
11111111111111111111111111111111111111111111111111: